NNNNNNNNNNNNNNNNN
NN.............NN
NN..........NN.NN
NN...........N.NN
N....N...N...N..N
NN...N...N...N.NN
NNN............NN
NNNN...........NN
NNNNNNNNNNNNNNNNN